████████████████████
█ █    █♦          █
█ █ ██ ██████  ███ █
█ @  █ █    █  █ █ █
███ ████ ██ █ ██ ░ █
█ █ █▒   █  █  █ ███
█   █ █  █¶    █   █
█ █ █ █  █ █████?███
█¤█   █  █    █   E█
████████████████████
