██████████████████████████████
█  █     █           █    ?  █
█  █  █  █  █████  █████  █  █
█     █  █    █   ¤    █  █  █
█  █████  ████████  █  █  █  █
█  ░   █   ▒        █     █  █
██████ ████  █  ███████████  █
█  █   █     █  █      ¶     █
█  █ ████  ███  █  █████████▓█
█        █   █     █     █   █
█  ████  ███@█████?█  █  █   █
█  █  █    █     █    █  █   █
█  █  ████ █████ █  ██████   █
█     █   ♦          █       E
██████████████████████████████