████████████████████████████████████████
█         █   █░      █    ¶  █        █
█ █████ ███ █ ███████ █ ███ ███ ██████ █
█   █   █@  █       █ █   █       █    █
█ ███ █████████ ███ █ █ █ █████████ ████
█   █       █   █   █   █        █    ♦█
█ ███████ █ █ ███ █████ ███ ███ ███ ████
█ ¤     █ █ █   █    ░█   █   █     █  █
█ █████ ███████ ███ █████ ███ ███████ ██
█ █   █           █       █@  █        █
█ ███ █████████ ███ ███████ ███ ████████
█     █       █  ?█       █   █    ▒   █
█████ █ ███ ███████ █████ ███ █████ ████
█     █   █       █     █   █       █  █
█ ███████ ███████▓███ █████ ███████ ████
█   █   █  ?     █    █   █      ▒█    █
█ ███ ███████ █████ ███ ████████████ ███
█          ▓█       █        █        E
████████████████████████████████████████
