██████████████████████████████████████████████████
█        █         █       █       █░          █ █
█ ██████ █ ███████ █ █████ ███ ███ ███ ███████ █ █
█ █    █ █     █   █     █       █     █         █
█ █ ██ ███████ █ ███████ ███████ ███████ █████████
█ █ ██ █       █ █     █ █     █ █               █
█ ████ █ ███████ █ ███ █ █ ███ ███████████████ █ █
█      @   █     █ █ █   █ █ █       █       █ █ █
██?███████ ███████ █ ███ ███ ███████ ▓ ███████ █ █
█  █       █     ▒     █ █   █       █     █   █ █
█ ███████ ███ ████████ ███ ███ ███████████ █ ███ █
█     █   █   █     █    █   █     ░    █    █   █
█████ █████ ███ █░███ █████ ███ ███ ███ ████████ █
█   █ █     █   █     █   █ █     █ █   █     █  █
█ ███ █ █████ ███ ███ ███ █ █ █████ █████ ███ █ ██
█ █  ¶  █   █     █  ¤  █ █ █ █     █     █   █  █
█ █████ █ █ ███████ ███ █ ███ █ █████ ███████ ██ █
█     █ █ █         █   █     █     █       █ ♦  █
█████ █ █ ███████ ███ ███ ███ █████ ███████ ██████
█     █ █     █   █   █   █ █     █      █       █
█ ███ █ ███ ███ █ █████ ███ ████ ███████ █████ ███
█ █▒█     █ █ █ █     █     █          █ ░ █     █
█ █ ███████ █ ███████ ███████ ███████████ ████████
█ █             █               █       █        █
████████████████████████████████████████████████E█
